acrimony	NN	ANGER
aggravate	VB	ANGER
agitate	VB	ANGER
anger	NN	ANGER
anger	VB	ANGER
angry	JJ	ANGER
animosity	NN	ANGER
annoy	VB	ANGER
annoyance	NN	ANGER
annoyed	JJ	ANGER
antagonism	NN	ANGER
antagonize	VB	ANGER
arouse	VB	ANGER
bitter	JJ	ANGER
bother	VB	ANGER
bummed	JJ	ANGER
bum	VB	ANGER
choler	NN	ANGER
conniption	NN	ANGER
crap	NN	ANGER
crazed	JJ	ANGER
crazy	JJ	ANGER
dander	NN	ANGER
damn	NN	ANGER
damn	JJ	ANGER
disapprobation	NN	ANGER
displease	VB	ANGER
displeasure	NN	ANGER
disturb	VB	ANGER
embitter	VB	ANGER
enmity	NN	ANGER
enrage	VB	ANGER
enraged	JJ	ANGER
exacerbate	VB	ANGER
exasperate	VB	ANGER
exasperated	JJ	ANGER
exasperation	NN	ANGER
fire up	VB	ANGER
foolish	JJ	ANGER
frantic	JJ	ANGER
fuck	NN	ANGER
furious	JJ	ANGER
fury	NN	ANGER
frustrated	JJ	ANGER
frustration	NN	ANGER
gall	VB	ANGER
hatred	NN	ANGER
huff	NN	ANGER
idiot	JJ	ANGER
idiot	NN	ANGER
impassioned	JJ	ANGER
incense	VB	ANGER
indignant	JJ	ANGER
indignation	NN	ANGER
inflame	VB	ANGER
infuriate	VB	ANGER
infuriation	NN	ANGER
irate	JJ	ANGER
irk	VB	ANGER
irritable	JJ	ANGER
irritate	VB	ANGER
irritated	JJ	ANGER
irritation	NN	ANGER
mad	JJ	ANGER
mad	NN	ANGER
offend	VB	ANGER
offended	JJ	ANGER
outrage	NN	ANGER
outrage	VB	ANGER
outraged	JJ	ANGER
peeve	VB	ANGER
pissed	JJ	ANGER
piss	VB	ANGER
pique	NN	ANGER
provoke	VB	ANGER
rage	NN	ANGER
rankle	VB	ANGER
raving	JJ	ANGER
resentful	JJ	ANGER
resentment	NN	ANGER
rile	VB	ANGER
shut	VB	ANGER
sullen	JJ	ANGER
stupid	JJ	ANGER
tantrum	NN	ANGER
tiff	NN	ANGER
trouble	VB	ANGER
umbrage	NN	ANGER
uptight	JJ	ANGER
vex	VB	ANGER
vexation	NN	ANGER
violence	NN	ANGER
annoy	VB	BOREDOM
bore	NN	BOREDOM
bore	VB	BOREDOM
bored	JJ	BOREDOM
boring	JJ	BOREDOM
bother	NN	BOREDOM
bother	VB	BOREDOM
bromide	NN	BOREDOM
bummer	JJ	BOREDOM
bummer	NN	BOREDOM
cloy	VB	BOREDOM
cloying	JJ	BOREDOM
commonplace	JJ	BOREDOM
creep	NN	BOREDOM
creepy	JJ	BOREDOM
deadhead	NN	BOREDOM
discomfort	VB	BOREDOM
disinterested	JJ	BOREDOM
drab	JJ	BOREDOM
dull	JJ	BOREDOM
dull	NN	BOREDOM
headache	NN	BOREDOM
humdrum	JJ	BOREDOM
inattentive	JJ	BOREDOM
irk	VB	BOREDOM
lifeless	JJ	BOREDOM
monotonous	JJ	BOREDOM
mundane	JJ	BOREDOM
pall	VB	BOREDOM
pest	NN	BOREDOM
pester	VB	BOREDOM
plebeian	JJ	BOREDOM
routine	JJ	BOREDOM
soporific	NN	BOREDOM
spiritless	JJ	BOREDOM
stale	JJ	BOREDOM
stereotyped	JJ	BOREDOM
stodgy	JJ	BOREDOM
stuffy	JJ	BOREDOM
stupid	JJ	BOREDOM
tedious	JJ	BOREDOM
tire	VB	BOREDOM
tiresome	JJ	BOREDOM
uninteresting	JJ	BOREDOM
vex	VB	BOREDOM
weary	VB	BOREDOM
yawn	NN	BOREDOM
activity	NN	ENTHUSIASM
agog	JJ	ENTHUSIASM
animated	JJ	ENTHUSIASM
ardent	JJ	ENTHUSIASM
ardor	NN	ENTHUSIASM
attracted	JJ	ENTHUSIASM
concerned	JJ	ENTHUSIASM
conviction	NN	ENTHUSIASM
dash	NN	ENTHUSIASM
devoted	JJ	ENTHUSIASM
devotion	NN	ENTHUSIASM
eager	JJ	ENTHUSIASM
eagerness	NN	ENTHUSIASM
earnest	JJ	ENTHUSIASM
earnestness	NN	ENTHUSIASM
ebullient	JJ	ENTHUSIASM
ecstasy	NN	ENTHUSIASM
elate	VB	ENTHUSIASM
energy	NN	ENTHUSIASM
enthuse	VB	ENTHUSIASM
enthusiasm	NN	ENTHUSIASM
enthusiastic	JJ	ENTHUSIASM
exhilarated	JJ	ENTHUSIASM
exhilaration	NN	ENTHUSIASM
fascinated	JJ	ENTHUSIASM
fervent	JJ	ENTHUSIASM
fervid	JJ	ENTHUSIASM
fervor	NN	ENTHUSIASM
glow	NN	ENTHUSIASM
gush	VB	ENTHUSIASM
hearty	JJ	ENTHUSIASM
hilarity	NN	ENTHUSIASM
hobby	NN	ENTHUSIASM
impetuosity	NN	ENTHUSIASM
intent	JJ	ENTHUSIASM
interest	NN	ENTHUSIASM
keen	JJ	ENTHUSIASM
keenness	NN	ENTHUSIASM
lively	JJ	ENTHUSIASM
mirth	NN	ENTHUSIASM
obsessed	JJ	ENTHUSIASM
oomph	NN	ENTHUSIASM
passion	NN	ENTHUSIASM
passionate	JJ	ENTHUSIASM
pep	NN	ENTHUSIASM
rapture	NN	ENTHUSIASM
relish	NN	ENTHUSIASM
spirited	JJ	ENTHUSIASM
tantalized	JJ	ENTHUSIASM
thrill	VB	ENTHUSIASM
thrilled	JJ	ENTHUSIASM
verve	NN	ENTHUSIASM
vigorous	JJ	ENTHUSIASM
vim	NN	ENTHUSIASM
vivacity	NN	ENTHUSIASM
willing	JJ	ENTHUSIASM
zeal	NN	ENTHUSIASM
zealous	JJ	ENTHUSIASM
zest	NN	ENTHUSIASM
agreeable	JJ	FUN
amuse	VB	FUN
amused	JJ	FUN
amusing	JJ	FUN
buffoonery	NN	FUN
celebration	NN	FUN
charming	JJ	FUN
cheer	VB	FUN
cheerful	JJ	FUN
cheering	JJ	FUN
clowning	JJ	FUN
comical	JJ	FUN
convivial	JJ	FUN
delightful	JJ	FUN
diverting	JJ	FUN
droll	JJ	FUN
enchanting	JJ	FUN
enjoy	VB	FUN
enjoyable	JJ	FUN
enjoyment	NN	FUN
entertain	VB	FUN
entertaining	JJ	FUN
entertainment	NN	FUN
festivity	NN	FUN
frolic	NN	FUN
fun	NN	FUN
fun	JJ	FUN
funny	JJ	FUN
gaiety	NN	FUN
gratifying	JJ	FUN
grins	NN	FUN
humorous	JJ	FUN
jocular	JJ	FUN
jocularity	NN	FUN
joke	VB	FUN
joke	NN	FUN
jokey	JJ	FUN
jollity	NN	FUN
joshing	JJ	FUN
joy	NN	FUN
junketing	NN	FUN
laughable	JJ	FUN
laughter	NN	FUN
lively	JJ	FUN
lol	NN	FUN
lol	JJ	FUN
merriment	NN	FUN
merry	JJ	FUN
merrymaking	NN	FUN
mirth	NN	FUN
pastime	NN	FUN
playfulness	NN	FUN
pleasant	JJ	FUN
please	VB	FUN
pleasing	JJ	FUN
pleasure	NN	FUN
recreation	NN	FUN
rejoicing	JJ	FUN
treat	NN	FUN
witty	JJ	FUN
appreciate	VB	HAPPINESS
appreciation	NN	HAPPINESS
beatitude	NN	HAPPINESS
blessedness	NN	HAPPINESS
bliss	NN	HAPPINESS
blissful	JJ	HAPPINESS
content	NN	HAPPINESS
contented	JJ	HAPPINESS
contentment	NN	HAPPINESS
delectation	NN	HAPPINESS
delight	NN	HAPPINESS
delighted	JJ	HAPPINESS
ecstasy	NN	HAPPINESS
elated	JJ	HAPPINESS
elation	NN	HAPPINESS
enchantment	NN	HAPPINESS
euphoria	NN	HAPPINESS
euphoric	JJ	HAPPINESS
exhilaration	NN	HAPPINESS
exited	JJ	HAPPINESS
exitement	NN	HAPPINESS
felicity	NN	HAPPINESS
gaiety	NN	HAPPINESS
geniality	NN	HAPPINESS
glad	JJ	HAPPINESS
gladness	NN	HAPPINESS
glee	NN	HAPPINESS
hilarity	NN	HAPPINESS
hopefulness	NN	HAPPINESS
joviality	NN	HAPPINESS
joy	NN	HAPPINESS
joyful	JJ	HAPPINESS
joyous	JJ	HAPPINESS
jubilant	JJ	HAPPINESS
jubilation	NN	HAPPINESS
jubliate	VB	HAPPINESS
lightheartedness	NN	HAPPINESS
lighthearted	JJ	HAPPINESS
lively	JJ	HAPPINESS
merriment	NN	HAPPINESS
merry	JJ	HAPPINESS
mirth	NN	HAPPINESS
optimism	NN	HAPPINESS
overjoyed	JJ	HAPPINESS
paradise	NN	HAPPINESS
peace of mind	NN	HAPPINESS
peaceful	JJ	HAPPINESS
playfulness	NN	HAPPINESS
pleasant	JJ	HAPPINESS
pleased	JJ	HAPPINESS
pleasure	NN	HAPPINESS
praise	VB	HAPPINESS
prosperity	NN	HAPPINESS
prosperous	JJ	HAPPINESS
rejoice	VB	HAPPINESS
rejoicing	NN	HAPPINESS
thrill	VB	HAPPINESS
thrilled	JJ	HAPPINESS
thrilling	JJ	HAPPINESS
upbeat	JJ	HAPPINESS
vivacity	NN	HAPPINESS
well-being	NN	HAPPINESS
abhor	VB	HATE
abhorred	JJ	HATE
abhorrence	NN	HATE
abominate	VB	HATE
abominated	JJ	HATE
abomination	NN	HATE
anathema	NN	HATE
anathematize	VB	HATE
anathematized	JJ	HATE
animosity	NN	HATE
animus	NN	HATE
antagonism	NN	HATE
antipathy	NN	HATE
aversion	NN	HATE
avoid	VB	HATE
avoided	JJ	HATE
bugbear	NN	HATE
condemn	VB	HATE
condemned	JJ	HATE
curse	VB	HATE
cursed	JJ	HATE
deplore	VB	HATE
deprecate	VB	HATE
deprecation	NN	HATE
deride	VB	HATE
despise	VB	HATE
detest	VB	HATE
detestation	NN	HATE
detested	JJ	HATE
disapprobation	NN	HATE
disapproval	NN	HATE
disapprove	VB	HATE
disdain	VB	HATE
disesteem	NN	HATE
disesteem	VB	HATE
disfavor	NN	HATE
disfavor	VB	HATE
disgust	NN	HATE
disgusted	JJ	HATE
disinclination	NN	HATE
disliked	JJ	HATE
disparage	VB	HATE
displeasure	NN	HATE
dispute	NN	HATE
dissatisfaction	NN	HATE
distaste	NN	HATE
enmity	NN	HATE
eschew	VB	HATE
execrate	VB	HATE
execrated 	JJ	HATE
execration	NN	HATE
frost	NN	HATE
grievance	NN	HATE
gripe	NN	HATE
hatred	NN	HATE
horror	NN	HATE
hostile	JJ	HATE
hostility	NN	HATE
implacability	NN	HATE
indisposition	NN	HATE
irritant	NN	HATE
loath	JJ	HATE
loathe	VB	HATE
loathed	JJ	HATE
loathing	NN	HATE
malevolence	NN	HATE
malignity	NN	HATE
nauseate	VB	HATE
nuisance	NN	HATE
objection	NN	HATE
odium	NN	HATE
offense	NN	HATE
opposition	NN	HATE
pain	NN	HATE
prejudice	NN	HATE
rancor	NN	HATE
rankling	NN	HATE
regret	VB	HATE
reluctant	JJ	HATE
repellent	JJ	HATE
repugnance	NN	HATE
repulsion	NN	HATE
resent	VB	HATE
resentment	NN	HATE
revenge	NN	HATE
revulsion	NN	HATE
scorn	NN	HATE
scorn	VB	HATE
shun	VB	HATE
shunned	JJ	HATE
spite	NN	HATE
spurn	VB	HATE
suck	VB	HATE
trouble	NN	HATE
venom	NN	HATE
admire	VB	LOVE
admirer	NN	LOVE
adore	VB	LOVE
adored	JJ	LOVE
adulate	VB	LOVE
affection	NN	LOVE
alluring	JJ	LOVE
angel	NN	LOVE
appreciate	VB	LOVE
appreciation	NN	LOVE
approve	VB	LOVE
beau	NN	LOVE
beloved	NN	LOVE
beloved	JJ	LOVE
canonize	VB	LOVE
captivating	JJ	LOVE
care for	VB	LOVE
cherish	VB	LOVE
cherished	JJ	LOVE
choose	VB	LOVE
courter	NN	LOVE
darling	NN	LOVE
dear	NN	LOVE
dearest	NN	LOVE
deify	VB	LOVE
delicate	JJ	LOVE
delicious	JJ	LOVE
delightful	JJ	LOVE
desire	VB	LOVE
devotion	NN	LOVE
emotion	NN	LOVE
enchanting	JJ	LOVE
engaging	JJ	LOVE
esteem	VB	LOVE
exalt	VB	LOVE
exclaim	VB	LOVE
exquisite	JJ	LOVE
fancy	VB	LOVE
fondness	NN	LOVE
friendship	NN	LOVE
glorify	VB	LOVE
gorgeous	JJ	LOVE
graceful	JJ	LOVE
handsome	JJ	LOVE
honey	NN	LOVE
idolize	VB	LOVE
inamorata	NN	LOVE
inamorato	NN	LOVE
infatuation	NN	LOVE
like	VB	LOVE
love	NN	LOVE
love	VB	LOVE
lovely	JJ	LOVE
lover	NN	LOVE
lust	NN	LOVE
paramour	NN	LOVE
passion	NN	LOVE
pleasant	JJ	LOVE
please	VB	LOVE
pleasing	JJ	LOVE
precious	JJ	LOVE
prefer	VB	LOVE
pretty	JJ	LOVE
prize	VB	LOVE
relish	VB	LOVE
respect	NN	LOVE
savor	VB	LOVE
spark	NN	LOVE
splendid	JJ	LOVE
stunning	JJ	LOVE
suitor	NN	LOVE
swain	NN	LOVE
sweet	NN	LOVE
sweet	JJ	LOVE
sweetheart	NN	LOVE
taste	NN	LOVE
tenderness	NN	LOVE
treasure	VB	LOVE
truelove	NN	LOVE
valentine	NN	LOVE
venerate	VB	LOVE
want	VB	LOVE
worship	VB	LOVE
yearning	NN	LOVE
allay	VB	RELIEF
allayed	JJ	RELIEF
alleviate	VB	RELIEF
alleviated	JJ	RELIEF
alleviation	NN	RELIEF
amelioration	NN	RELIEF
appeased	JJ	RELIEF
appeasement	NN	RELIEF
assistance	NN	RELIEF
assuage	VB	RELIEF
assuagement	NN	RELIEF
balm	NN	RELIEF
breather	NN	RELIEF
calm	VB	RELIEF
cared	JJ	RELIEF
comfort	NN	RELIEF
comfort	VB	RELIEF
comfortable	JJ	RELIEF
comforted	JJ	RELIEF
consolation	NN	RELIEF
consoled	JJ	RELIEF
contentment	NN	RELIEF
cure	VB	RELIEF
deliverance	NN	RELIEF
diminish	VB	RELIEF
ease	VB	RELIEF
extrication	NN	RELIEF
fix	NN	RELIEF
free	VB	RELIEF
freed	JJ	RELIEF
happiness	NN	RELIEF
mitigate	VB	RELIEF
mitigation	NN	RELIEF
mollification	NN	RELIEF
mollified	JJ	RELIEF
pacified	JJ	RELIEF
palliative	NN	RELIEF
placated	JJ	RELIEF
reassured	JJ	RELIEF
reconciled	JJ	RELIEF
refreshment	NN	RELIEF
relax	VB	RELIEF
relaxed	JJ	RELIEF
relief	NN	RELIEF
relieved	JJ	RELIEF
relieving	JJ	RELIEF
reprieve	NN	RELIEF
respite	NN	RELIEF
satisfaction	NN	RELIEF
satisfied	JJ	RELIEF
solaced	JJ	RELIEF
soothe	VB	RELIEF
soothed	JJ	RELIEF
ache	VB	SADNESS
afflict	VB	SADNESS
aggrieve	VB	SADNESS
agonize	VB	SADNESS
anguish	NN	SADNESS
bad	JJ	SADNESS
bear	VB	SADNESS
bemoan	VB	SADNESS
bereaved	JJ	SADNESS
bewail	VB	SADNESS
bitter	JJ	SADNESS
blahs	NN	SADNESS
bleakness	NN	SADNESS
blue	JJ	SADNESS
bummer	NN	SADNESS
cheerless	JJ	SADNESS
cheerlessness	NN	SADNESS
complain	VB	SADNESS
constrain	VB	SADNESS
crush	VB	SADNESS
cry	VB	SADNESS
dark	JJ	SADNESS
dejected	JJ	SADNESS
dejection	NN	SADNESS
deplore	VB	SADNESS
depressing	JJ	SADNESS
despairing	JJ	SADNESS
despondency	NN	SADNESS
despondent	JJ	SADNESS
disconsolate	JJ	SADNESS
disconsolateness	NN	SADNESS
dismal	JJ	SADNESS
dispiritedness	NN	SADNESS
distress	NN	SADNESS
distressed	JJ	SADNESS
doleful	JJ	SADNESS
dolefulness	NN	SADNESS
dolor	NN	SADNESS
down	JJ	SADNESS
downer	NN	SADNESS
dysphoria	NN	SADNESS
endure	VB	SADNESS
forlornness	NN	SADNESS
funk	NN	SADNESS
gloominess	NN	SADNESS
grief	NN	SADNESS
heartache	NN	SADNESS
heartbreak	NN	SADNESS
heartbroken	JJ	SADNESS
hopelessness	NN	SADNESS
hurt	VB	SADNESS
injure	VB	SADNESS
keen	VB	SADNESS
lament	VB	SADNESS
letdown	NN	SADNESS
listlessness	NN	SADNESS
melancholy	JJ	SADNESS
melancholy	NN	SADNESS
miserable	JJ	SADNESS
misery	NN	SADNESS
moodiness	NN	SADNESS
mopes	NN	SADNESS
mournful	JJ	SADNESS
mournfulness	NN	SADNESS
mourning	NN	SADNESS
moving	JJ	SADNESS
pain	VB	SADNESS
pathetic	JJ	SADNESS
pessimistic	JJ	SADNESS
pitiful	JJ	SADNESS
poignancy	NN	SADNESS
poignant	JJ	SADNESS
regret	VB	SADNESS
regrettable	JJ	SADNESS
rue	VB	SADNESS
sad	JJ	SADNESS
sadden	VB	SADNESS
serious	JJ	SADNESS
somber	JJ	SADNESS
sorrow	NN	SADNESS
sorrow	VB	SADNESS
sorrowful	JJ	SADNESS
sorrowfulness	NN	SADNESS
sorry	JJ	SADNESS
suffer	VB	SADNESS
tragic	JJ	SADNESS
tribulation	NN	SADNESS
unhappy	JJ	SADNESS
wail	VB	SADNESS
weep	VB	SADNESS
wistful	JJ	SADNESS
woe	NN	SADNESS
wound	VB	SADNESS
afflict	VB	WORRY
afraid	JJ	WORRY
aggrieve	VB	WORRY
agonize	VB	WORRY
ail	VB	WORRY
anguish	NN	WORRY
annoy	VB	WORRY
annoyance	NN	WORRY
apprehension	NN	WORRY
apprehensive	JJ	WORRY
bedevil	VB	WORRY
beleaguer	VB	WORRY
beset	VB	WORRY
beside oneself	JJ	WORRY
bother	VB	WORRY
bothered	JJ	WORRY
brood	VB	WORRY
chafe	VB	WORRY
clutched	JJ	WORRY
concern	NN	WORRY
concerned	JJ	WORRY
depress	VB	WORRY
despair	VB	WORRY
disquiet	NN	WORRY
disquiet	VB	WORRY
distracted	JJ	WORRY
distraught	JJ	WORRY
distress	NN	WORRY
distress	VB	WORRY
distressed	JJ	WORRY
disturb	VB	WORRY
disturbed	JJ	WORRY
doubt	NN	WORRY
dun	VB	WORRY
fear	NN	WORRY
fearful	JJ	WORRY
fret	VB	WORRY
frightened	JJ	WORRY
goad	VB	WORRY
harass	VB	WORRY
hassle	VB	WORRY
hector	VB	WORRY
importune	VB	WORRY
irritate	VB	WORRY
misery	NN	WORRY
misgiving	NN	WORRY
nervous	JJ	WORRY
oppress	VB	WORRY
persecute	VB	WORRY
perturb	VB	WORRY
perturbed	JJ	WORRY
pester	VB	WORRY
plague	VB	WORRY
problem	NN	WORRY
stew	VB	WORRY
tense	JJ	WORRY
tormented	JJ	WORRY
trouble	VB	WORRY
uncertainty	NN	WORRY
uneasiness	NN	WORRY
unsettle	VB	WORRY
upset	VB	WORRY
upset	JJ	WORRY
vex	VB	WORRY
woe	NN	WORRY
worried	JJ	WORRY
worry	NN	WORRY
worry	VB	WORRY
worrying	JJ	WORRY